"a" = (/turf/space,/area)
"b" = (/turf/simulated/wall,/area/engine/port_gyro_bay)
"c" = (/obj/structure/grille,/obj/structure/window/reinforced,/obj/structure/window/reinforced{dir = 8},/obj/structure/window/reinforced{dir = 1},/turf/simulated/floor/plating,/area/engine/port_gyro_bay)
"d" = (/obj/structure/grille,/obj/structure/window/reinforced,/obj/structure/window/reinforced{dir = 1},/turf/simulated/floor/plating,/area/engine/port_gyro_bay)
"e" = (/obj/structure/grille,/obj/structure/window/reinforced,/obj/structure/window/reinforced{dir = 4},/obj/structure/window/reinforced{dir = 1},/turf/simulated/floor/plating,/area/engine/port_gyro_bay)
"f" = (/obj/effect/landmark{name = "JoinLate"},/obj/effect/landmark/start{name = "Captain"},/obj/effect/landmark/start,/turf/simulated/floor,/area/engine/port_gyro_bay)
"g" = (/turf/simulated/floor,/area/engine/port_gyro_bay)
"h" = (/obj/machinery/light{dir = 4; icon_state = "tube1"},/turf/simulated/floor,/area/engine/port_gyro_bay)
"i" = (/obj/structure/grille,/obj/structure/window/reinforced{dir = 4},/obj/structure/window/reinforced{dir = 8},/obj/structure/window/reinforced{dir = 1},/turf/simulated/floor/plating,/area/engine/port_gyro_bay)
"j" = (/obj/machinery/power/apc{name = "Aft Hall APC"; dir = 8; pixel_x = -25; pixel_y = 1},/turf/simulated/floor,/area/engine/port_gyro_bay)
"k" = (/obj/item/weapon/gun/energy/laser,/turf/simulated/floor,/area/engine/port_gyro_bay)
"l" = (/obj/multiz/ladder{icon_state = "ladderup"},/turf/simulated/floor,/area/engine/port_gyro_bay)
"m" = (/obj/structure/grille,/obj/structure/window/reinforced{dir = 4},/obj/structure/window/reinforced{dir = 8},/turf/simulated/floor/plating,/area/engine/port_gyro_bay)
"n" = (/obj/item/clothing/head/helmet/space/rig,/turf/simulated/floor,/area/engine/port_gyro_bay)
"o" = (/obj/item/clothing/head/hardhat/red,/turf/simulated/floor,/area/engine/port_gyro_bay)
"p" = (/obj/structure/grille,/obj/structure/window/reinforced,/obj/structure/window/reinforced{dir = 4},/obj/structure/window/reinforced{dir = 8},/turf/simulated/floor/plating,/area/engine/port_gyro_bay)
"q" = (/obj/machinery/light,/turf/simulated/floor,/area/engine/port_gyro_bay)
"r" = (/obj/effect/landmark/zcontroller{up = 1; up_target = 2},/turf/space,/area)
"s" = (/turf/simulated/wall,/area/bridge/meeting_room)
"t" = (/turf/simulated/floor,/area/bridge/meeting_room)
"u" = (/obj/machinery/portable_atmospherics/canister/toxins,/turf/simulated/floor,/area/bridge/meeting_room)
"v" = (/turf/simulated/floor/open,/area/bridge/meeting_room)
"w" = (/obj/multiz/ladder,/turf/simulated/floor,/area/bridge/meeting_room)
"x" = (/obj/effect/landmark/zcontroller{down = 1; down_target = 1},/turf/space,/area)

(1,1,1) = {"
aaaaaaaaaaaaaaaaaaaaaaaaaaaaaa
aaaaaaaaaaaaaaaaaaaaaaaaaaaaaa
aaaaaaaaaaaaaaaaaaaaaaaaaaaaaa
aaaaaaaaaaaaaaaaaaaaaaaaaaaaaa
aaaaaaaaaaaaaaaaaaaaaaaaaaaaaa
aaaaaaaaaaaaaaaaaaaaaaaaaaaaaa
aaaaaaaaaaaaaaaaaaaaaaaaaaaaaa
aaaaaaaaaaaaaaaaaaaaaaaaaaaaaa
aaaaaaaaaaaaaaaaaaaaaaaaaaaaaa
aaaaaaaaaaaaaaaaaaaaaaaaaaaaaa
aaaaaaaaaaaaaaaaaaaaaaaaaaaaaa
aaaaabbbbbcddebbbbaaaaaaaaaaaa
aaaaabfggggggggghbaaaaaaaaaaaa
aaaaabgggggggggggiaaaaaaaaaaaa
aaaaabjggggkggglgmaaaaaaaaaaaa
aaaaabggggnggggggmaaaaaaaaaaaa
aaaaabgggggggggggmaaaaaaaaaaaa
aaaaabggggggoggggpaaaaaaaaaaaa
aaaaabgggqgggggggbaaaaaaaaaaaa
aaaaabbbbbcddebbbbaaaaaaaaaaaa
aaaaaaaaaaaaaaaaaaaaaaaaaaaaaa
aaaaaaaaaaaaaaaaaaaaaaaaaaaaaa
aaaaaaaaaaaaaaaaaaaaaaaaaaaaaa
aaaaaaaaaaaaaaaaaaaaaaaaaaaaaa
aaaaaaaaaaaaaaaaaaaaaaaaaaaaaa
aaaaaaaaaaaaaaaaaaaaaaaaaaaaaa
aaaaaaaaaaaaaaaaaaaaaaaaaaaaaa
aaaaaaaaaaaaaaaaaaaaaaaaaaaaaa
aaaaaaaaaaaaaaaaaaaaaaaaaaaaaa
raaaaaaaaaaaaaaaaaaaaaaaaaaaaa
"}

(1,1,2) = {"
aaaaaaaaaaaaaaaaaaaaaaaaaaaaaa
aaaaaaaaaaaaaaaaaaaaaaaaaaaaaa
aaaaaaaaaaaaaaaaaaaaaaaaaaaaaa
aaaaaaaaaaaaaaaaaaaaaaaaaaaaaa
aaaaaaaaaaaaaaaaaaaaaaaaaaaaaa
aaaaaaaaaaaaaaaaaaaaaaaaaaaaaa
aaaaaaaaaaaaaaaaaaaaaaaaaaaaaa
aaaaaaaaaaaaaaaaaaaaaaaaaaaaaa
aaaaaaaaaaaaaaaaaaaaaaaaaaaaaa
aaaaaaaaaaaaaaaaaaaaaaaaaaaaaa
aaaaaaaaaaaaaaaaaaaaaaaaaaaaaa
aaaaasssssssssssssaaaaaaaaaaaa
aaaaastttttttutttsaaaaaaaaaaaa
aaaaastttttttttttsaaaaaaaaaaaa
aaaaastttvvvvvtwtsaaaaaaaaaaaa
aaaaastttvvvvvtttsaaaaaaaaaaaa
aaaaastttvvvvvtttsaaaaaaaaaaaa
aaaaastttttttttttsaaaaaaaaaaaa
aaaaastttttttttttsaaaaaaaaaaaa
aaaaasssssssssssssaaaaaaaaaaaa
aaaaaaaaaaaaaaaaaaaaaaaaaaaaaa
aaaaaaaaaaaaaaaaaaaaaaaaaaaaaa
aaaaaaaaaaaaaaaaaaaaaaaaaaaaaa
aaaaaaaaaaaaaaaaaaaaaaaaaaaaaa
aaaaaaaaaaaaaaaaaaaaaaaaaaaaaa
aaaaaaaaaaaaaaaaaaaaaaaaaaaaaa
aaaaaaaaaaaaaaaaaaaaaaaaaaaaaa
aaaaaaaaaaaaaaaaaaaaaaaaaaaaaa
aaaaaaaaaaaaaaaaaaaaaaaaaaaaaa
xaaaaaaaaaaaaaaaaaaaaaaaaaaaaa
"}
